lul	Laugh out loud
lol	Laugh out loud
lolz	Laugh out loud
lawl	Laugh out loud
lawlz	Laugh out loud
lal	Laugh out loud
lel	Laugh out loud
LMAO	Laughing my ass off
LMFAO	Laughing my fucking ass off
ROFL	Rolling on the floor laughing
ROFLMAO	Rolling on the floor laughing my ass off
ROTFLMFAO	Rolling on the floor laughing my fucking ass off
lqtm	Laughing quietly to myself
OMG	Oh my god
SMH	Shaking my head
FFS	For fuck's sake
FML	Fuck my life
STFU	Shut the fuck up
GTFO	Get the fuck out
DGAF	Don't give a fuck
DTF	Down to fuck
SMFH	Shaking my fucking head
PTFO	Passed the fuck out
BL	Belly laughing
BAS	Big ass smile
BFD	Big fucking deal
BMGWL	Busting my gut with laughter
BWL	Bursting with laughter
CRBT	Crying real big tears
ESAD	Eat shit and die
FOMCL	Falling off my chair laughing
FUBAR	Fucked up beyond all repair or recognition
GMAB	Give me a break
LHO	Laughing head off
LMSO	Laughing my socks off
LOL	Laughing out loud
LSHMBH	Laughing so hard my belly hurts
LTM	Laugh to myself
NFG	No fucking good
NFW	No feasible way or no fucking way
OTF	Off the floor
PITA	Pain in the ass
ROTFLMAOWPIMP	Rolling on the floor laughing my ass off while peeing in my pants
ROTFLMBO	Rolling on the floor laughing my butt off
STFU	Shut the fuck up
SWL	Screaming with laughter
UAPITA	You're a pain in the ass
WTFO	What the Fuck! Over!